0 *X** -> E 3
0 *E** -> X 1
1 X*** -> N 0
1 N*** -> X 2
2 **X* -> W 1
2 **W* -> X 3
3 ***X -> S 2
3 ***S -> X 0
