0 X*** -> N 3
0 N*** -> X 1
1 *X** -> E 0
1 *E** -> X 2
2 **X* -> W 1
2 **W* -> X 3
3 ***X -> S 2
3 ***S -> X 0
